00000000000000000000000000000000
00000000000000000000000000000000
00000000000000000000000000000000
00000000000000000000000000000000
00001000000010000000100000001000
00001000000010000000100000001000
00001000000010000000100000001000
00001000000010000000100000001000
00001000000010000000100000001000
00001000000010000000100000001000
00001000000010000000100000001000
00001000000010000000100000001000
00001000100010001000100010001000
00001000100010001000100010001000
00001000100010001000100010001000
00001000100010001000100010001000
00001000100010001000100010001000
00001000100010001000100010001000
00001000100010001000100010001000
00001000100010001000100010001000
00000000100000001000000010000000
00000000100000001000000010000000
00000000100000001000000010000000
00000000100000001000000010000000
00000000100000001000000010000000
00000000100000001000000010000000
00000000100000001000000010000000
00000000100000001000000010000000
00000000000000000000000000000000
00000000000000000000000000000000
00000000000000000000000000000000
00000000000000000000000000000000
